NO ./TEXTURES/spiral
SO ./TEXTURES/spiral
WE ./TEXTURES/spiral
EA ./TEXTURES/spiral

F 255,0,0
C 255,0,0

11111111111
12222222221
12222222221
12222222221
12220002221
12220N02221
12220002221
12222222221
12222222221
12222222221
11111111111