NO ./TEXTURES/path_to_north_texture
SO ./TEXTURES/path_to_south_texture
WE ./TEXTURES/path_to_west_texture
EA ./TEXTURES/path_to_east_texture

F 220,100,0
C 0,0,255

        1111111111111111111111111
        1000000000110000000000001
        101100000111000000000000
        1001000000000000000000001
111111111111111111111111111111111

111111111111111111111111111111111
111111111011000001110000000000001
100000000011000001110111121111111
11110111111111011100000013001
111101111111110111010100100011
11000000110101011100000010001
100000000000000011000000100011
10000000000000001101010010001
11000001110101011111011110N0111
11110111 1110101 101111010001
11111111 1111111 1111111111111
